######################
#E       ######### ###
#### ##    ####      #
####U#####      ###K #
####   ###### ######F#
######################