E  ############################
                  #           #
#  #  #######  ####  #  ####  #
#  #     #  #  #     #     #  #
####  #  #  #  #######  #  ####
#  #  #  #  #     #  #  #     #
#  ####  #  #  #  #  #  ####  #
#  #     #     #     #     #  #
#  ####  #  #############  ####
#     #  #        #           #
####  #######  ####  ##########
#     #        #        #     #
####  #  #  ####  #  #######  #
#        #        #        #  #
####  #######  ####  #  ####  #
#     #  #        #  #        #
#  ####  ####  #  #  #  #  #  #
#     #  #     #  #  #  #  #  #
#  #  #  #  ################  #
#  #  #                 #      
############################F #